60
20
111111111111111111111111111111111111111111111111111111111111
100000000000111111111111111111111111111111111111111111111111
100000000000111111111111111111111111111111111111111111111111
100000300000111000000000000000000000000000111111111111111111
100000000000111000000000000000000000000000111111111111111111
100000000000111000000000000000000000000000111111111111111111
111111000111111000000000000000000000000000111111111111111111
111111000111111000000000000000000000000000111111111111111111
111111000000002000000000000000000000000000222222222222222222
111111100000002000000000000000000000000000222222222222222222
111111111111111000000000000000000000000000111111111111111111
111111111111111000000000000000000000000000111111111111111111
111111111111111000000000000000000000000000111111111111111111
111111111111111000000000000000000000000000111111111111111111
111111111111111000000000000000000000000000111111111111111111
111111111111111000000000000000000000000000111111111111111111
111111111111111111111111111111111111111111111111111111111111
111111111111111111111111111111111111111111111111111111111111
111111111111111111111111111111111111111111111111111111111111
111111111111111111111111111111111111111111111111111111111111